1111111
1PE0001
100N101
1111101
1000001
100N101
1111101
1000001
100N101
1111111
