11111111111111111111
100000010C0110000001
1000C001000100C00001
100010N1000000000E01
100110000N00000N0001
10N0100000C010000N01
1000000N001110000001
1P000C0000100000C001
10000000000C00000001
11111111111111111111