1111111
10PCCC1
1CCCCC1
1CCCCE1
1111111